111111111111111111111111111111111
100000C0000P01111011111C000011C01
111111111100001110111111111011101
11111111111110000000000C000000001
10C000100000001000001111111111001
111100000111100000000001110000001
100000000000000000000000110001111
110000000C00000000000000100000011
111111111111111110000000000000001
1C0000000000000000000000000000001
111111111111111111111100000000E01
111111111111111111110000000000001
11111C000000000000000000011111111
111111111111111111111111111111111